[
-----------------------------------------------------------------------------------------------------------------------------------------------------------------------------------------------------------------------------------------|
-                               -                                                                                                                                                                                                       -|
-P                              -                                                                  ---                                                                                                                                  -|
---                             ---                                                                                          ----                                                      ----                           ----              -|
-                   -----       -           --                ---                                                                                                                                                                       -|
-      ----                     -                                                  -----                                                           ----                ----                                                             -|
-                               -                                                                              -----                                                                                                                    -|
-                               -                -----                                                                                                                                 ----              --- ---                        -|
----                -----       -                                      ---                           ----                                    ----                  -----                                                                -|
-                               -                                                                                                                                                                                                       -|
-          ---                  -                                                                                        -----                                                                                          ------          -|
-                               -                             ---               ---           ----                                                                                                                                      -|
-----                           -       ----                                                                                                         -----                  ----                   ----                                 -|
-                       ---     -                                                                                                                                                                                                       -|  
-                               -                                                                         ---                      -------                                          ----                              ---               -|
-                               -----                                                                                                                                                                                                   -|
-           ----                -                                                                                                                                                                 ------                                -|                                                                     -|
-                               -           -----                   -----             ---               -                                                       ----                                                                    -|
-                               -                                                                                                        ---                                                                                            -|
-   ----                        -                                                                                      ---                                                            -------            -   ---                        -|
-                    ----       -                                                          ----                                                                                                                                         -|
-                               -                                                                                                                -----                                                                                  -|
-                               -**************************************************************************************************************************************************************************************                 -|
-                               ---------------------------------------------------------------------------------------------------------------------------------------------------------------------------------------                 -|
-             ----                                                                                                                                                                                                                      -|
-                                                                                                                                                                                                        ------                         -|
-                                   ----                                          -----                                                                   ----            -----                                                         -|
-    ------                                                    ----                                                              -------                                                                                 --------       -|
-                                                                                               ----                                                                                     -----                                          -|
-                   ----                   ----                                                                                                                      ------                                    ------                   -|
-                                                                                                              ----                                                                                                                     -|
-                                 ----                                 -----            -----                                                         ----                                         -----                                -|
-       ----                                    ----                                                                             ------                                        ----                                                     -|
-                                                                                                                                                                                                              -------                  -|
-                             -----                                                                                                                                                                                                     -|
-                                                        ----                           ------                -----                            -----               ------                                                               -|
-                   -----                                                                                                                                                                             -----                      ----   -|
-     ----                                                                                                                                                                        ------                                                -|
-                                       ----                            -----                                                  -----                                                                                                    -|
-                                                                                                                                             ------                                                                                    -|
-               ----                               ----                                 -------                       ------                                                                                                            -|
-                                                                                                       -----                                                                     ------                          -------               -|
-                                                        -----                                                                                               ------                                                                     -|
-                                 -----                                       -----                                         ----                                                                   ----                                 -|
-     ---                                                                                     --------                                                                                                                      ---         -|
-                                                                                                                                                                                                                                       -|
-***************************************************************************************************************************************************************************************************************************************-|
-----------------------------------------------------------------------------------------------------------------------------------------------------------------------------------------------------------------------------------------|
]

player 1100 44 

monster 700 800 3 1 1000 1000

monster 2000 800 3 1 1000 1000

monster 3000 1000 3 1 1000 1000

monster 2000 1500 3 1 1000 1000

monster 3000 400 3 1 1000 1000

monster 634 300 3 1 1000 1000

monster 300 800 3 1 1000 1000

monster 1000 800 3 1 1000 1000

monster 700 542 3 1 1000 1000

monster 1300 1580 3 1 1000 1000

monster 400 1400 3 1 1000 1000

monster 1400 1800 3 1 1000 1000

monster 300 400 3 1 1000 1000

monster 2400 300 3 1 1000 1000

monster 2500 200 3 1 1000 1000








/
